11111111
100100C1
10001001
1P00E001
111111
