1111111111
1010101111
101001011F
