1111111111111111
1P00000C0000CC01
110C011100001101
101000010C000111
1000C001000011E1
1111111111111111
