1111111111111111
1P00000C0000CC01
110C011100001101
101000010C0P0011
1000C001000010E1
1111111111111111
