1111111111111111
1P00000C0XX0CC01
110C011100001101
10100X010C000X01
1000C001000011E1
1111111111111111
