111111
1E0CC1
101001
101001
1P0001
111111
