11111111111
1P00000C001
110C0111001
101000010C1
1000C0010E1
11111111111
